⼁	ㄍㄨㄣˇ
⼂	ㄓㄨˇ
⼅	ㄐㄩㄝˊ
⼛	ㄙ
⼡	ㄓˇ
⼴	ㄧㄢˇ
⼵	ㄧㄣˇ
⼺	ㄕㄢ
㑳	ㄓㄡˋ
㑿	ㄓㄠˋ
㒓	ㄊㄚˋ
㓦	ㄅㄛˋ
㔩	ㄜˋ
㕙	ㄐㄩㄣˋ
㖡	ㄧㄝˋ
㖪	ㄩˋ
㛂	ㄋㄨㄛˇ
㞞	ㄙㄨㄥˊ
㟏	ㄏㄢ
㥄	ㄌㄧㄥˊ
㥏	ㄊㄧㄢˇ
㩐	ㄉㄣˋ
㩳	ㄙㄨㄥˇ
㫃	ㄧㄢˇ
㬊	ㄏㄨㄢˇ
㭘	ㄒㄧㄚˊ
㲪	ㄉㄥ
㲯	ㄌㄢˊ
㵝	ㄧˋ
㵞	ㄔㄡˊ
㶁	ㄍㄨㄛˊ
㷍	ㄌㄨㄣˊ
㸌	ㄏㄨㄛˋ
㸙	ㄓㄜ
㹜	ㄧㄣˊ
䀇	ㄍㄨˇ
䀠	ㄐㄩˋ
䀢	ㄕㄨㄣˋ
䁑	ㄕˋ
䆿	ㄧˋ
䈰	ㄕㄠ
䈾	ㄕㄠ
䉶	ㄕㄨㄤ
䍡	ㄌㄨˋ
䍦	ㄌㄧˊ
䍪	ㄨㄚˋ
䏿	ㄑㄧˇ
䐶	ㄗㄢ
䒷	ㄍㄨㄚ
䖳	ㄓㄚˋ
䖵	ㄎㄨㄣ
䖹	ㄇㄧˇ
䘿	ㄐㄩㄝˊ
䛟	ㄐㄧㄚˊ
䟫	ㄔㄥˊ
䠷	ㄊㄧㄠˇ
䨲	ㄋㄡˊ
䫄	ㄔㄨㄚˋ
䫏	ㄑㄧ
䰀	ㄨㄛˇ
䰐	ㄌㄢˊ
䰰	ㄖㄨˊ
丂	ㄎㄠˇ
丩	ㄐㄧㄡ
丿	ㄆㄧㄝˇ
乙	ㄧˇ
乣	ㄉㄧㄡ
亠	ㄊㄡˊ
仫	ㄇㄨˋ
佊	ㄅㄧˇ
侊	ㄍㄨㄤ
倈	ㄌㄞˊ
倝	ㄍㄢˋ
倮	ㄌㄨㄛˇ
傈	ㄌㄧˋ
傉	ㄋㄨˋ
儹	ㄗㄢˇ
冂	ㄐㄩㄥ
冖	ㄇㄧˋ
冫	ㄅㄧㄥ
凇	ㄙㄨㄥ
剨	ㄏㄨㄛˋ
劐	ㄏㄨㄛ
勑	ㄌㄞˋ
勹	ㄅㄠ
匸	ㄒㄧˋ
卂	ㄒㄩㄣˋ
卩	ㄐㄧㄝˊ
厓	ㄧㄞˊ
参	ㄙㄢ
叒	ㄖㄨㄛˋ
叕	ㄓㄨㄛˊ
吔	˙ㄧㄝ
呝	ㄜˋ
咵	ㄎㄨㄚˇ
哰	ㄌㄠˊ
唓	ㄔㄜ
唕	ㄗㄠˋ
唫	ㄧㄣˊ
嗞	ㄗ
嘚	ㄉㄜ
噇	ㄔㄨㄤˊ
噏	ㄒㄧ
噔	ㄉㄥ
嚱	ㄒㄧ
坂	ㄅㄢˇ
坄	ㄧˋ
垍	ㄐㄧˋ
垡	ㄈㄚˊ
埝	ㄋㄧㄢˋ
夨	ㄗㄜˋ
夲	ㄊㄠ
媖	ㄧㄥ
媠	ㄊㄨㄛˇ
嫏	ㄌㄤˊ
孴	ㄋㄧˇ
宀	ㄇㄧㄢˊ
尀	ㄆㄛˇ
屵	ㄜˋ
崡	ㄏㄢˊ
嶀	ㄊㄨ
嶾	ㄧㄣˇ
巛	ㄔㄨㄢ
幐	ㄊㄥˊ
幺	ㄠ
弆	ㄐㄩˇ
彐	ㄐㄧˋ
恑	ㄍㄨㄟˇ
憁	ㄗㄨㄥˇ
憙	ㄒㄧˇ
戹	ㄜˋ
扅	ㄧˊ
掆	ㄍㄤ
掿	ㄋㄨㄛˋ
揞	ㄢˇ
揢	ㄎㄜˊ
摣	ㄓㄚ
撂	ㄌㄧㄠˋ
撧	ㄐㄩㄝ
擀	ㄍㄢˇ
攞	ㄌㄨㄛ
攧	ㄉㄧㄢ
攴	ㄆㄨ
敫	ㄐㄧㄠˋ
敻	ㄒㄩㄥˋ
无	ㄨˊ
晁	ㄔㄠˊ
杘	ㄔ
枊	ㄤˋ
柜	ㄐㄩˇ
栘	ㄧˊ
栙	ㄒㄧㄤˊ
梡	ㄎㄨㄢˇ
槅	ㄍㄜˊ
橈	ㄋㄠˊ
檞	ㄐㄧㄝˇ
欇	ㄕㄜˋ
殜	ㄧㄝˋ
殹	ㄧ
沘	ㄅㄧˇ
溚	ㄉㄚˊ
滺	ㄧㄡ
漊	ㄌㄡˊ
潚	ㄒㄧㄠ
烕	ㄒㄩㄝˋ
焿	ㄍㄥ
煏	ㄅㄧˋ
燋	ㄐㄧㄠ
犼	ㄏㄡˇ
狧	ㄊㄚˋ
猍	ㄌㄞˊ
獏	ㄇㄨˊ
獕	ㄘㄨㄟ
玍	ㄍㄚˇ
珉	ㄇㄧㄣˊ
瓓	ㄌㄢˊ
疁	ㄌㄧㄡˊ
疃	ㄊㄨㄢˇ
疒	ㄔㄨㄤˊ
疱	ㄆㄠˋ
痃	ㄒㄧㄢˊ
痆	ㄋㄧㄝˋ
癔	ㄧˋ
癶	ㄅㄛ
皀	ㄒㄧㄤ
睃	ㄐㄩㄣˋ
睺	ㄏㄡˊ
瞖	ㄧˋ
瞘	ㄎㄡ
瞤	ㄕㄨㄣˋ
矉	ㄆㄧㄣˊ
矲	ㄅㄚˋ
砈	ㄜˋ
硇	ㄋㄠˊ
硶	ㄔㄣˇ
磶	ㄒㄧˋ
礴	ㄅㄛˊ
稗	ㄅㄞˋ
稘	ㄐㄧ
竱	ㄓㄨㄢˇ
筢	ㄆㄚˊ
篼	ㄉㄡ
簺	ㄙㄞˋ
籋	ㄋㄧㄝˋ
籰	ㄩㄝˋ
絣	ㄅㄥ
縪	ㄅㄧˋ
罱	ㄌㄢˇ
羓	ㄅㄚ
肽	ㄊㄞˋ
腊	ㄒㄧˊ
腼	ㄇㄧㄢˇ
膪	ㄔㄨㄞˋ
臁	ㄌㄧㄢˊ
臤	ㄑㄧㄢ
舚	ㄊㄧㄢˋ
芪	ㄑㄧˊ
苄	ㄅㄧㄢˋ
苷	ㄍㄢ
茝	ㄔㄞˇ
莂	ㄅㄧㄝˊ
萘	ㄋㄞˋ
萲	ㄒㄩㄢ
蒒	ㄕ
蒕	ㄩㄣ
蓲	ㄡ
蔈	ㄅㄧㄠ
藣	ㄅㄟ
蛼	ㄔㄜ
蜹	ㄖㄨㄟˋ
蝎	ㄏㄜˊ
蝥	ㄇㄠˊ
蝲	ㄌㄚˋ
螋	ㄙㄡ
螌	ㄅㄢ
螠	ㄧˋ
衠	ㄓㄨㄣ
袜	ㄇㄛˋ
袠	ㄓˋ
裓	ㄍㄜˊ
褌	ㄎㄨㄣ
褟	ㄊㄚ
襀	ㄐㄧ
襒	ㄅㄧㄝˊ
襘	ㄍㄨㄟˋ
襵	ㄓㄜˊ
謏	ㄒㄧㄠˇ
謟	ㄊㄠ
謼	ㄏㄨ
躧	ㄒㄧˇ
軏	ㄩㄝˋ
輥	ㄍㄨㄣˇ
辡	ㄅㄧㄢˋ
辵	ㄔㄨㄛˋ
逩	ㄅㄣˋ
遬	ㄙㄨˋ
酶	ㄇㄟˊ
釙	ㄆㄛˋ
釾	ㄧㄝˊ
鉈	ㄊㄚ
鉕	ㄆㄛˇ
鉳	ㄅㄟˇ
鉷	ㄏㄨㄥˊ
銱	ㄉㄧㄠˋ
鍅	ㄈㄚˇ
鍩	ㄋㄨㄛˋ
鍮	ㄊㄡ
鐗	ㄐㄧㄢˋ
鐭	ㄠˋ
鑔	ㄔㄚˇ
鑥	ㄌㄨˇ
閦	ㄔㄨˋ
阫	ㄆㄟˊ
隥	ㄉㄥˋ
隶	ㄉㄞˋ
霙	ㄧㄥ
靧	ㄏㄨㄟˋ
鞓	ㄊㄧㄥ
鞴	ㄅㄟˋ
鞹	ㄎㄨㄛˋ
鞼	ㄍㄨㄟˋ
韂	ㄔㄢˋ
韠	ㄅㄧˋ
韽	ㄢˋ
頟	ㄜˊ
頫	ㄈㄨˇ
頮	ㄏㄨㄟˋ
顬	ㄖㄨˊ
飿	ㄉㄨㄛˋ
餜	ㄍㄨㄛˇ
餦	ㄓㄤ
餶	ㄍㄨˇ
饆	ㄅㄧˋ
饊	ㄙㄢˇ
饠	ㄌㄨㄛˊ
饡	ㄗㄞˋ
駊	ㄆㄛˇ
騀	ㄜˇ
骲	ㄅㄛˊ
髴	ㄈㄨˊ
髿	ㄙㄨㄛ
鬇	ㄓㄥ
鬉	ㄗㄨㄥ
鬡	ㄋㄧㄥˊ
魭	ㄨㄢˇ
鮋	ㄧㄡˊ
鮎	ㄋㄧㄢˊ
鮟	ㄢˋ
鮻	ㄙㄨㄛ
鯿	ㄅㄧㄢ
鰂	ㄗㄜˊ
鰮	ㄨㄣ
鰵	ㄇㄧㄣˇ
鱇	ㄎㄤ
鴟	ㄔ
鵮	ㄑㄧㄢ
鷧	ㄧˋ
麨	ㄔㄠˇ
黁	ㄋㄨㄣˊ
黐	ㄔ
鼂	ㄔㄠˊ
齍	ㄗ
齭	ㄔㄨˇ